40 40 40 40 40 40 40 40 40 40 40 40 40 40 40 40 40 40
40 40 51 45 45 45 45 45 45 45 45 45 45 45 45 50 40 40
40 40 47 39 24 24 25 24 24 25 24 24 24 39 24 46 40 40
40 40 47 24 24 24 24 21 12 20 24 24 24 39 24 46 40 40
40 40 47 25 24 24 25 15 19 14 24 24 24 24 24 46 40 40
40 40 47 24 24 24 24 15 19 14 24 09 24 24 24 46 40 40
40 40 47 39 24 24 21 13 19 11 12 12 12 20 39 46 40 40
40 40 47 24 25 09 15 19 19 19 19 19 19 14 39 46 40 40
40 40 47 24 24 39 15 19 19 19 19 19 19 14 39 46 40 40
40 40 47 24 24 39 15 19 19 19 19 19 19 14 39 46 40 40
40 40 47 24 24 39 15 19 19 19 19 19 19 14 39 46 40 40
40 40 47 24 24 39 15 19 19 19 19 19 19 14 39 46 40 40
40 40 47 24 24 39 23 17 17 17 17 17 17 22 39 46 40 40
40 40 53 48 49 48 49 49 48 49 49 48 49 49 49 52 40 40