40 40 40 40 40 40 40 40 40 40 40 40 40 40 40 40 40 40
40 40 51 45 45 45 45 45 45 45 45 45 45 45 45 50 40 40
40 40 47 24 24 24 25 24 24 25 24 24 24 24 24 46 40 40
40 40 47 24 24 24 24 24 24 24 24 24 24 24 24 46 40 40
40 40 47 25 24 24 25 24 24 25 24 24 24 24 24 46 40 40
40 40 47 24 24 24 24 24 24 24 24 09 24 24 24 46 40 40
40 40 47 24 24 24 25 24 24 24 24 24 25 24 24 46 40 40
40 40 47 24 25 09 24 24 24 24 24 24 24 24 24 46 40 40
40 40 47 24 24 24 24 24 24 24 24 24 24 25 24 46 40 40
40 40 47 24 24 24 24 24 24 25 24 24 24 24 24 46 40 40
40 40 47 24 24 24 24 24 09 24 24 24 24 24 24 46 40 40
40 40 47 24 24 24 25 24 24 24 24 24 25 24 24 46 40 40
40 40 47 25 24 24 24 24 24 24 24 24 24 24 24 46 40 40
40 40 47 24 24 25 24 24 24 24 24 24 24 24 24 46 40 40
40 40 53 48 49 48 49 49 48 49 49 48 49 49 49 52 40 40
40 40 40 40 40 40 40 40 40 40 40 40 40 40 40 40 40 40
40 40 40 40 40 40 40 40 40 40 40 40 40 40 40 40 40 40
40 40 40 40 40 40 40 40 40 40 40 40 40 40 40 40 40 40