40 40 40 40 40 40 40 40 40 40 40 40 40 40 40 40 40 40
40 40 51 45 45 45 45 45 45 50 40 51 45 45 45 50 40 40
40 40 47 24 24 24 25 24 24 31 30 29 24 24 24 46 40 40
40 40 47 24 24 24 24 24 24 34 33 32 24 24 24 46 40 40
40 40 47 25 24 24 25 24 24 28 27 26 24 24 24 46 40 40
40 40 47 24 24 24 24 24 24 46 40 47 24 24 24 46 40 40
40 40 47 24 24 24 25 24 24 46 40 53 49 49 49 52 40 40
40 40 47 24 24 25 24 24 24 46 40 40 40 40 40 40 40 40
40 40 47 24 24 24 24 24 24 24 24 24 24 25 24 46 40 40
40 40 53 48 49 02 05 08 49 49 48 48 49 49 49 52 40 40
40 40 40 40 40 01 04 07 40 40 40 40 40 40 40 40 40 40
40 40 51 45 45 00 03 06 45 45 45 45 45 45 45 50 40 40
40 40 47 25 24 24 24 24 24 24 24 24 24 24 24 46 40 40
40 40 53 48 49 48 49 49 48 49 49 48 49 49 49 52 40 40