25 25 25 25 39 39 39 39 39 39 39 39 39 39 39 39 39 39
25 39 39 25 39 39 39 39 39 39 39 25 25 25 25 25 39 39
25 39 39 24 24 24 24 39 39 24 25 24 24 39 24 24 25 24
25 39 39 24 43 44 24 39 39 24 43 44 24 39 24 43 44 24
25 39 39 24 41 42 24 39 39 24 41 42 24 39 24 41 42 24
25 39 39 24 24 24 24 39 39 24 24 24 24 39 24 24 24 24
25 39 39 39 39 39 25 39 39 25 39 39 39 39 25 39 39 39
25 39 39 39 39 39 25 39 39 25 39 39 39 39 25 39 39 39
25 39 39 24 24 24 24 39 39 24 24 24 24 39 24 24 24 24
25 39 39 24 43 44 24 39 39 24 43 44 24 39 24 43 44 24
25 39 39 24 41 42 24 39 39 24 41 42 24 39 24 41 42 24
25 39 39 24 24 24 24 25 25 24 24 24 24 39 24 24 24 24
25 39 39 25 39 39 39 39 39 39 39 39 39 39 39 39 39 39
25 25 25 25 39 39 39 39 39 39 39 39 39 39 39 39 39 39