9 9 9 9 9 9 9 9 9 9 9 9 9 9 9 9 9 9
9 39 39 39 39 39 39 39 39 39 39 39 39 39 39 39 39 9
9 39 24 24 24 24 24 24 24 24 24 24 24 24 24 24 24 24
9 39 24 39 24 39 39 39 39 39 39 39 39 39 39 24 39 24
9 39 24 39 24 9 9 24 24 24 24 24 24 24 39 24 39 24
9 39 24 39 24 9 9 24 9 9 9 9 9 24 39 24 39 24
9 39 24 39 24 9 9 24 9 9 9 9 9 24 39 24 39 24
9 39 24 39 24 9 9 24 9 9 24 24 24 24 39 24 39 24
9 39 24 39 24 9 9 24 9 9 24 9 9 9 39 24 39 24
9 39 24 39 24 24 24 24 9 9 24 24 24 24 39 24 39 24
9 39 24 39 39 39 39 39 39 39 39 39 39 24 39 24 39 24
9 39 24 24 24 24 24 24 24 24 24 24 24 24 24 24 39 24
9 39 24 39 39 39 39 39 39 39 39 39 39 39 39 39 39 24
9 9 24 24 24 24 24 24 24 24 24 24 24 24 24 24 24 24